2.....2.....................................
0000000000..................................
0000000000..................................
............................................
............................................
............................................
............................................
0000000000......0000000........0000000......
............................................
............................................
A...........................................