2...2..2.......
2...2..........
...............
...............
...............
000000000000000
...............
...............
A..............