1............
.............
.............
.............
.............
00000........
.............
.............
A............