wwwwwwwwwwwwwwwwwwwwwwwwwwww
wiiiiiiiiiiiiiiiiiiiiiiiiiiw
w.._......_......._......_.w
w.-...-.............-......w
wttt+tt++++ttt+tt+ttt++++ttw
w.._..-..._.......-......_.w
w.-..._............._......w
w++++++++++++S+++++++++++++w
wwwwwwwwwwwwwwwwwwwwwwwwwwww