wwwwwwwwwwwwwwwwwwwwwwwwwwww
wiiiiiiiiiiiiiiiiiiiiiiiiiiw
w....x.....................w
w......x..............x....w
w............x.............w
w++++++++++++++++++++++++++w
wtt+++tt+t+t+tt++t+ttt+t+ttw
w......l.....l........l....w
w.......l..................w
w.l.....................l..w
w++++++++++++S+++++++++++++w
wwwwwwwwwwwwwwwwwwwwwwwwwwww