wwwwwwwwwwwwwwwwwwwwwwwwwwww
wiiiiiiiiiiiiiiiiiiiiiiiiiiw
w._........................w
w......_.............._....w
w............_.............w
w............_........_....w
w......._..................w
w._....................._..w
w++++++++++++S+++++++++++++w
wwwwwwwwwwwwwwwwwwwwwwwwwwww
