wwwwwwwwwwwwwwwwwwwwwwwwwwww
wiiiiiiiiiiiiiiiiiiiiiiiiiiw
w....l...l............l....w
w++++++++++++++++++++++++++w
wtttt+ttt+tttttttttttttt+ttw
w.....-........-...........w
w.....x.......x............w
w++++++++++++++++++++++++++w
wtttttttt+tttttttttttttt+ttw
w........_............_....w
w...........l.........l....w
w++++++++++++++++++++++++++w
wtttttttttttttt+tttttttttttw
w......x...........x.......w
w++++++++++++S+++++++++++++w
wwwwwwwwwwwwwwwwwwwwwwwwwwww
